


C     50,0,0
WE  ./textures/bookshelf
SO   ./textures/bookshelf
EA  ./textures/bookshelf
F    100,0,0

NO                       ./textures/bookshelf
111111111111111111111111111111111111111111
100000000000000000000000000000000000000001
100000000000000000000000000000000000000001
10000000000000000000000E000000000000000001
100000000000000000000000000000000000000001
100000000000000000000000000000000000000001
100000000000000000000000000000000000000001
111111111111111111111111111111111111111111